########
#.######
# $. ###
#  $  ##
## #  ##
#  $ ###
#@    .#
########
